11111111111111111111111111
1E000CCC0000C000000C000001
10111110111110111110001111
100000000000CCC00000000001
11110111111111111111000111
1C000000000000C000000000C1
10111110111110111110111101
100000C0000000000000000001
11110111110111110001111111
1C00000C000000CCC0000000P1
11111111111111111111111111
